DDDDDD-XXXXXX---DDDDDX
DDDDDD--XXX-----DDDDDX
XXXXXDDDDXDDDDDDDDDDDD
XXXXXDDDDXDDDDDDDXXXDX
DDDDDDDDDDDDDDDDDDDDDX
DDXXDDDDDDDDXXXDDDDDDX
XDDDDDDDXDDDDDDDXXXXDD
XDXDDDDDXXXXDDDDDDXXDD
XDDXDDDDDXDXDDDDXXXXDD
XDDXXDDXXDDDDDXXXXXXDD