DDDDDDXDDDDD
DXDXXDXDDDDD
DXDXXDDDDDDD
DXXDXDXDDDDD
DXDDDDDDDDDD
XDDDXDXXXDDD
DXDDXDXDDDDD
DDXXDDXDXDDD
DDDXDDXXXDDD
DDXDDDXDDXDD
DXDDDDDDDDXD
DDDDDDDDDDDD