DDDDDXDDDDXDDD
DDDDDDDDDDDDDD
DDDDDDDDDDDDDD
DDDXDDDXDDDDDD
DDDDDDDDDDDDDD
DDDDXDDDDXDDDD
DDDDDDDDDDDDDD
DDXDDDDDXDDDDX
DDXDDDDDXDDDDD
DDDDXDDDDDDDDD
DDDDDDDXDDDDDD
DDXDDDDDDXDDDD
DDDDDDDDDDDDDD