DDXXXXXXXXXXDD
XDDXXXXXXXXDDX
XXDDXXXXXXDDXX
XXXDDXXXXDDXXX
XXXXDDDDDDXXXX
XXXXXXDXXXXXXX
XXXXXXDXXXXXXX
XXXXXXDXXXXXXX
XXXXXDDDXXXXXX
XXXXDDXDDXXXXX
XXXDDXXXDDXXXX
XXDDXXXXXDDXXX
XDDXXXXXXXDDXX
DDXXXXXXXXXDDX