XXXXXXXXDDXXXXXXXXXXX
XXXXXXXDDDXXXXXXXXXXX
XXXXXXDDXDDDDDDXXXXXX
XXXXXDDXXXDDDDDDDXXXX
XXXXDDXXXXXDDDDDDXXXX
XXXDDXXXXXXXDDDDXXXXX
XXDDXXXXXXXXXDDXXXXXX
DDXXXXXXXXXXXXDDXXXXX
XDDXXXXXXXXXXXXDDXXXX
XXDDXXXXXXXXXXXXDDXXX
XXXDDXXXXXXXXXXXXDDXX
XXXXDDDDDDDDDDDDDDDXX
XXXXXDDDDDDDDDDDXXXXX
XXXXXXDDDDDDDDDDXXXXX
XXXXXXXDDDDDDDDDXXXXX
XXXXXXXXDDXXXXXXXXXXX
XXXXXXXXXXXXXXXXXXXXX
XXXXXXXXXXXXXXXXXXXXX
XXXXXXXXXXXXXXXXXXXXX
XXXXXXXXXXXXXXXXXXXXX
XXXXXXXXXXXXXXXXXXXXX