DXXXXXXXXXXXXXXXXXXDD
DDXXXXXXXXXXXXXXXXDDD
DDDXXXXXXXXXXXXXXDDDD
DDDDXXXXXXXXXXXXDDDDD
DDDDDXXXXXXXXXXDDDDDD
DDDDDDXXXXXXXXDDDDDDD
DDDDDDDXXXXXXDDDDDDDD
DDDDDDDDXXXXDDDDDDDDD
DDDDDDDDDDDDDDDDDDDDD
DDDDDDDDDDDDDDDDDDDDD
DDDDDDDDDDDDDDDDDDDDD
DDDDDDDDDDDDDDDDDDDDD
DDDDDDDDDDDDDDDDDDDDD
DDDDDDDDDDDDDDDDDDDDD
DDDDDDDDDDDDDDDDDDDDD
DDDDDDDDDDDDDDDDDDDDD
DDDDDDDDDDDDDDDDDDDDD
DDDDDDDDDDDDDDDDDDDDD
DDDDDDDDDDDDDDDDDDDDD
DDDDDDDDDDDDDDDDDDDDD
DDDDDDDDDDDDDDDDDDDDD