DXXXXXXXXXXXXXXXXXXDD
DDXXXXXXXXXXXXXXXXDDD
DDDXXXXXXXXXXXXXXDDDD
DDDDXXXXXXXXXXXXDDDDD
DDDDDXXXXXXXXXXDDDDDD
DDDDDDXXXXXXXXDDDDDDD
DDDDDDDXXXXXXDDDDDDDD
DDDDDDDDXXXXDDDDDDDDD
DDDDDDDDDDXDDDDDDDDDD
DDDDXDDDDDXDDDDDDDDDD
DDDDXDDDDDXDDDDDDDDDD
DDDDXDDDDDXXDDDDDDDDD
DDDDXDDDDDXDDDDDDDDDD
DDDDDDDDDDXDDDDDDDDDD
DDDDDDDDDDXDDDDDDDDDD
DDDDDDDDDDXDDDDDDDDDD
DDDDDDDDDDXDDDDDDDDDD
DDDDDDDDDDXDDDDDDDDDD
DDDDDDDDDDXDDDDDDDDDD
DDDDDDDDDDXDDDDDDDDDD
DDDDDDDDDDDDDDDDDDDDD