XXXXXXXXXXXXXX
XXXXXXXXXXXXXX
XXXXXXXXXXXXXX
XXXXXXXXXXXXXX
XXXXXXXXXXXXXX
XXXXXXXDXXXXXX
XXXXXXDDXXXXXX
XXXXXDDDDXXXXX
XXXXDDDDDDXXXX
XXXDDDDDDDDXXX
XXDDDDDDDDDDXX
XDDDDDDDDDDDDX
XXXXXXXXXXXXXX
XXXXXXXXXXXXXX