DDDDDDDD
DXDXXDXD
DDDXXDDD
DXXDXDXD
DXDDDDDD
DDDDXDXD
DDDDXDDD
DDDDDDDD