DDDDDDDDD
DXDXXDXDD
DXDXXDDDD
DXXDXDXDD
DXDDDDDDD
DDDDXDXDD
DXDDXDDDD
DDXDDDDDD
DDDDDDDDD