DDDDDDDDDD
DXDXXDXDDD
DXDXXDDDDD
DXXDXDXDDD
DXDDDDDDDD
DDDDXDXXXD
DXDDXDDDDD
DDXDDDDDDD
DDDDDDXXXD
DDDDDDDDDD