DDDDDDXDDDD
DXDXXDXDDDD
DXDXXDDDDDD
DXXDXDXDDDD
DXDDDDDDDDD
XDDDXDXXXDD
DXDDXDXDDDD
DDXDDDXDXDD
DDDDDDXXXDD
DDDDDDXDDDD
DDDDDDDDDDD