XXDXDDDD
XDDDDXXX
DXXDDDDX
XDDDDDDD
DDDDDXXX