XXXXDDDDXX
XDDDDXDDDD
DDDDDDDXXX
XDDDDDDDXX
DDDDDXDDDD