XXXXXXDDXX
XXDDDDDDDD
XXXXDDDXXX
XDDDDDDDXX
XDDDDXDDDD