DDDDDDDD
XXDDDXXX
XXXDDDXX
DDDDXXXX
XDDDDDXX