DDDXDDDD
XXDDDXXX
DXXDXXXX
DDDDXXDD
XDDDDDDX